{	{0, 34, 34, 34, 34, 34, 34, 34, 34, 34, 34, 0, 0, 0, 0, 0, 0, 34, 34, 34, 34, 34, 34, 34, 34, 34, 34, 0},
													{34, 130, 130, 130, 130, 130, 130, 130, 130, 130, 130, 34, 0, 0, 0, 0, 34, 130, 130, 130, 130, 130, 130, 130, 130, 130, 130, 34},
													{34, 130, 130, 130, 130, 130, 130, 130, 130, 130, 130, 34, 0, 0, 0, 0, 34, 130, 130, 130, 130, 130, 130, 130, 130, 130, 130, 34},
													{34, 130, 130, 130, 130, 130, 130, 130, 130, 130, 130, 34, 0, 0, 0, 0, 34, 130, 130, 130, 130, 130, 130, 130, 130, 130, 130, 34},
													{34, 130, 130, 130, 130, 130, 130, 130, 130, 130, 130, 130, 34, 34, 34, 34, 130, 130, 130, 130, 130, 130, 130, 130, 130, 130, 130, 34},
													{34, 130, 130, 130, 130, 130, 130, 130, 130, 130, 130, 130, 130, 130, 130, 130, 130, 130, 130, 130, 130, 130, 130, 130, 130, 130, 130, 34},
													{34, 130, 130, 130, 130, 130, 130, 130, 130, 130, 130, 130, 130, 130, 130, 130, 130, 130, 130, 130, 130, 130, 130, 130, 130, 130, 130, 34},
													{34, 130, 130, 130, 130, 130, 130, 130, 130, 130, 130, 130, 34, 34, 34, 34, 130, 130, 130, 130, 130, 130, 130, 130, 130, 130, 130, 34},
													{34, 130, 130, 130, 130, 130, 130, 130, 130, 130, 130, 34, 0, 0, 0, 0, 34, 130, 130, 130, 130, 130, 130, 130, 130, 130, 130, 34},
													{34, 130, 130, 130, 130, 130, 130, 130, 130, 130, 130, 34, 0, 0, 0, 0, 34, 130, 130, 130, 130, 130, 130, 130, 130, 130, 130, 34},
													{34, 130, 130, 130, 130, 130, 130, 130, 130, 130, 130, 34, 0, 0, 0, 0, 34, 130, 130, 130, 130, 130, 130, 130, 130, 130, 130, 34},
													{0, 34, 34, 34, 34, 34, 34, 34, 34, 34, 34, 0, 0, 0, 0, 0, 0, 34, 34, 34, 34, 34, 34, 34, 34, 34, 34, 0} };